0,0,0,0,31,0,0,20,11,11,3,15,20,0,3,0,26,0,0,0,21,11,31,21,6,0,9,0,0,0,22,0,4,27,28,7,0,2,48,46,30,49,57,72,76,100,55,42,18,50,32,32,3,25,0,0,0,17,1,0,0,32,28,10,7,13,27,0,45,22,42,79,72,73,93,63,61,23,21,45,15,24,44,26,34,62,9,39,0,0,0,0,0,24,18,6,0,0,0,11
15,0,21,8,2,0,0,0,0,19,0,31,1,0,0,0,4,1,11,3,0,0,6,0,0,0,0,0,0,9,0,7,11,8,0,0,30,36,0,11,17,57,77,100,100,82,43,28,33,35,0,30,11,13,17,21,0,16,0,0,0,0,0,28,10,0,19,0,34,25,72,95,100,92,100,72,68,49,19,39,50,57,19,65,90,24,19,63,2,23,19,31,24,0,0,7,0,0,2
0,2,0,0,0,28,0,0,0,19,0,0,1,18,31,24,0,0,0,0,25,1,0,0,5,0,23,2,0,0,0,20,0,17,30,24,0,5,13,24,69,66,60,87,100,72,90,35,12,48,8,11,0,7,6,0,0,24,0,0,9,19,20,23,6,0,0,18,62,82,76,68,94,100,91,43,54,67,0,52,59,24,86,100,79,73,88,14,47,44,0,0,0,0,0,0,19,0
10,5,9,28,28,28,12,0,0,2,0,28,20,2,19,0,0,28,0,0,0,7,0,32,31,19,0,31,31,9,10,0,0,6,0,4,0,0,18,37,11,77,71,71,47,57,27,37,11,19,8,0,0,13,23,12,0,0,0,12,22,16,0,0,0,0,0,4,43,66,59,97,92,69,79,67,21,59,25,65,53,67,92,71,74,100,52,57,57,38,0,0,24,0,0,0,0
12,1,0,0,0,0,6,23,0,0,5,31,12,0,18,34,0,0,0,0,0,23,20,0,0,12,10,0,0,20,0,0,0,0,0,0,26,0,0,14,45,51,42,45,32,34,69,50,8,20,0,0,11,9,5,16,0,0,14,0,20,0,0,6,0,33,2,5,0,33,59,87,79,60,76,74,61,44,6,34,40,78,84,76,88,62,49,56,7,20,14,0,3,0,1,0
0,0,0,6,0,0,0,0,0,31,17,33,0,3,2,0,2,35,2,48,42,0,38,3,21,19,0,0,0,0,0,18,31,0,0,0,0,0,32,23,1,52,48,60,35,56,43,38,40,20,0,31,0,0,28,25,0,21,0,13,8,30,26,0,7,0,6,6,0,57,61,35,40,52,52,71,59,12,18,11,14,31,80,100,91,83,62,69,62,49,37,0,15,3,0
7,0,11,31,31,0,0,5,0,28,0,33,8,35,0,29,11,24,16,31,52,40,9,0,0,0,0,0,27,0,0,16,14,0,8,0,26,3,29,2,14,21,43,46,41,40,0,0,0,32,0,0,9,0,0,0,17,0,6,2,0,28,14,0,0,24,13,8,22,43,5,43,62,56,36,23,11,5,17,11,29,85,46,62,100,57,84,57,35,23,6,30,0,23
31,30,0,6,13,0,26,0,31,0,19,23,8,40,16,38,67,79,85,82,65,41,11,2,36,27,17,11,2,24,0,3,0,11,0,0,15,0,0,0,29,0,36,0,15,24,0,0,16,6,0,0,0,0,18,10,14,28,0,0,25,0,6,0,14,21,0,0,0,0,0,0,25,6,53,3,5,0,28,45,0,49,75,46,91,49,23,38,32,0,2,0,13
0,16,13,23,0,11,4,0,0,3,0,13,29,35,63,67,90,53,48,86,35,59,0,28,7,0,0,27,27,9,0,0,0,25,0,16,1,28,0,7,0,31,13,35,0,12,0,26,7,0,0,22,24,0,0,24,3,0,2,32,28,22,0,6,4,30,13,16,0,11,0,24,11,0,13,19,3,0,2,0,42,32,62,11,40,14,31,12,40,35,30,15
0,22,23,0,0,0,11,31,0,9,0,40,21,8,12,86,68,68,59,78,69,35,39,21,23,0,0,0,0,20,15,0,23,30,0,32,5,0,14,0,0,28,0,19,0,11,0,16,30,0,0,12,40,23,31,28,6,0,0,0,9,8,13,0,5,18,21,14,0,43,49,27,59,37,52,18,12,0,36,11,35,17,9,40,38,5,49,34,18,13,0
4,7,5,0,0,0,12,16,0,0,0,17,4,2,68,52,100,95,92,100,100,40,33,53,37,0,3,0,19,0,6,22,0,0,0,24,0,10,0,22,0,19,4,8,0,0,0,33,15,25,9,32,8,0,44,0,12,28,30,0,25,0,0,30,24,0,19,3,27,23,12,30,42,55,59,37,22,16,9,34,13,39,15,27,0,29,18,0,0,3
0,19,0,26,3,0,0,25,0,41,29,39,18,51,30,70,99,100,78,88,100,82,9,47,0,35,8,2,8,24,4,16,0,11,15,0,0,0,22,0,25,20,0,0,0,0,25,0,0,24,25,28,27,24,37,47,18,0,23,32,12,22,11,0,31,9,14,25,44,4,21,64,47,47,17,17,12,23,0,0,8,8,0,24,32,13,4,8,0
0,13,30,37,0,42,28,3,38,21,16,13,14,38,47,50,90,80,76,62,39,73,12,9,0,0,30,0,21,0,3,0,28,0,20,0,0,0,23,0,16,0,0,21,20,11,18,14,40,0,33,50,41,44,34,60,45,6,0,11,0,19,23,0,0,0,0,38,25,51,80,100,100,99,38,33,14,10,0,0,0,0,4,3,32,17,22,25
10,40,39,28,51,30,17,30,78,36,50,78,19,17,69,60,39,86,46,60,68,46,10,6,17,0,0,0,0,21,0,0,4,0,19,0,0,36,17,24,0,36,32,38,0,0,0,14,15,26,74,63,52,73,61,41,56,27,28,0,26,0,2,28,24,0,7,1,64,64,75,100,70,67,41,41,5,47,40,22,2,5,0,19,28,0,0
15,37,16,67,51,30,48,72,47,75,91,75,45,39,38,71,36,33,27,29,66,25,0,0,0,29,0,18,6,10,5,31,0,0,7,5,29,29,12,26,42,7,19,27,7,0,0,16,43,42,52,67,55,91,94,78,72,39,53,8,20,6,24,18,0,5,25,52,68,76,100,100,100,100,79,79,14,24,17,0,0,0,0,0,31,0
15,70,37,53,100,66,93,81,94,100,100,100,64,66,61,8,57,62,27,4,39,20,7,4,12,0,16,0,6,13,3,0,0,0,0,19,26,7,40,24,45,22,23,32,13,48,31,53,7,55,60,78,68,94,100,100,78,14,6,44,22,18,0,3,21,30,6,28,68,100,93,100,100,86,100,77,59,30,5,12,0,18,14,0,0
44,56,79,58,70,85,100,77,90,100,69,85,57,68,55,43,20,50,0,28,19,13,34,26,0,19,9,0,2,0,0,0,0,0,34,6,2,27,28,46,78,78,60,80,40,28,4,18,18,79,90,78,84,100,78,80,85,53,12,37,0,28,0,4,24,29,25,35,67,67,100,100,100,100,95,36,5,8,0,21,22,0,1,0
64,48,91,100,70,75,100,95,100,100,100,89,73,53,21,24,0,19,27,20,0,0,5,21,20,0,5,0,0,0,12,0,0,24,19,47,36,50,87,87,59,86,58,69,75,50,71,56,69,35,35,53,71,99,65,41,57,31,5,0,0,0,0,31,22,5,59,47,88,81,72,73,100,68,100,37,53,0,8,19,20,0,3
41,97,83,91,72,100,85,100,100,100,100,76,83,13,56,16,0,34,0,18,0,32,22,0,16,0,29,0,6,19,21,0,10,0,27,6,17,58,59,56,78,100,95,92,86,80,86,70,70,42,32,74,50,72,73,68,17,50,3,3,19,0,0,32,7,4,52,69,96,100,79,74,100,75,82,22,2,40,0,0,27,12
26,95,80,100,86,100,96,77,100,100,62,86,49,55,0,3,0,0,7,0,0,0,0,31,7,0,0,0,11,23,0,0,16,0,22,17,59,62,52,100,100,100,88,100,89,97,94,100,31,43,60,28,41,45,25,24,42,23,8,9,26,32,28,33,40,26,74,59,79,100,100,92,83,63,90,11,1,38,18,0,30
25,73,64,100,69,98,73,66,72,50,72,65,39,20,20,0,0,32,18,0,13,8,21,5,0,0,0,4,0,0,0,21,0,9,0,35,25,43,91,85,77,100,100,82,91,90,100,59,88,80,65,38,39,1,4,44,11,0,33,20,2,24,15,4,29,19,61,78,80,100,100,82,99,52,44,5,22,34,26,0
41,63,84,42,59,53,100,50,63,64,58,71,41,43,0,23,31,15,3,0,0,0,0,0,9,0,0,0,26,0,12,0,28,0,0,6,48,37,98,77,87,100,72,100,100,95,100,94,45,43,14,4,30,44,43,40,10,28,0,30,4,28,24,23,28,67,76,47,100,76,100,99,73,53,44,33,35,35,18
49,23,34,46,49,41,55,60,61,53,43,20,14,38,24,19,28,0,0,31,9,0,0,0,19,12,0,0,0,0,31,26,0,0,17,11,45,23,58,59,100,77,100,68,100,100,90,100,68,20,32,14,29,42,10,36,33,0,0,0,3,16,32,54,43,71,69,74,95,100,100,99,69,73,12,0,0,0
17,29,29,45,67,34,54,65,66,82,82,67,23,7,0,0,0,3,0,0,0,19,31,17,27,18,0,0,5,0,0,0,17,10,32,0,0,35,71,47,95,100,100,100,77,100,100,87,74,37,18,5,0,0,0,13,18,0,0,33,8,3,44,11,80,84,77,100,99,88,86,61,55,50,0,26,0
30,39,50,21,49,76,77,92,100,94,71,48,31,27,0,10,2,21,0,27,0,0,20,0,0,11,8,0,3,0,4,22,0,0,5,6,42,1,59,75,58,100,87,83,100,100,70,83,39,29,11,0,20,32,0,0,25,20,11,33,7,1,7,41,88,78,60,69,100,100,99,36,63,19,50,33
0,39,0,55,26,46,75,67,97,99,80,30,47,0,42,0,5,0,0,7,16,31,23,0,0,0,7,12,13,7,8,30,0,3,11,38,46,22,39,78,100,100,98,100,100,80,47,55,40,41,38,17,7,11,15,26,25,0,32,0,1,0,17,43,100,100,83,100,100,54,76,27,18,0,37
0,31,18,18,37,68,51,79,100,77,45,74,39,31,0,9,0,0,0,26,15,18,0,7,22,27,0,0,12,0,0,19,24,0,10,4,0,45,56,100,100,69,99,100,64,76,70,25,32,16,0,0,0,0,18,4,16,29,10,0,26,43,27,87,67,92,100,100,85,47,67,4,51,25
0,32,11,25,64,81,54,68,68,82,49,33,5,0,0,28,0,22,26,4,7,0,0,0,0,0,17,30,0,31,0,3,27,22,30,22,42,62,39,62,100,100,79,100,71,92,57,13,10,11,0,0,0,18,0,5,0,0,0,17,15,26,45,40,94,67,100,75,100,69,44,19,0
31,23,28,14,19,20,31,52,76,38,61,15,8,0,21,0,0,0,0,0,0,0,31,0,0,29,0,1,26,19,30,0,13,2,0,0,35,14,38,100,85,100,89,89,100,40,57,0,45,10,5,22,0,0,0,0,0,0,0,0,37,17,26,56,79,95,99,100,68,59,33,0
5,0,0,2,33,16,36,59,53,46,13,58,0,32,10,13,0,8,31,0,0,0,11,0,0,14,0,0,0,0,0,20,2,0,0,0,34,25,94,91,65,94,79,96,71,33,34,0,0,0,0,11,0,0,24,23,24,0,3,33,0,1,63,46,68,84,53,82,78,26,38
0,42,38,50,4,31,21,53,11,19,8,52,14,10,27,0,0,29,0,12,30,0,0,1,0,20,17,14,0,0,0,0,0,0,31,51,26,47,58,100,100,71,68,90,54,45,14,45,0,16,2,0,0,0,8,18,0,16,0,6,37,19,0,11,64,43,63,28,66,49
0,5,41,22,5,12,56,52,15,52,30,41,0,21,33,20,19,31,15,0,18,0,0,0,0,0,31,0,23,0,5,4,0,0,29,11,80,74,57,100,78,69,100,54,43,55,1,13,6,4,1,0,26,0,5,0,24,7,0,1,10,0,0,11,42,51,23,2,27
27,32,11,21,73,57,46,44,29,0,0,8,0,20,0,0,23,1,0,0,25,0,0,0,0,3,10,0,0,0,0,28,0,0,26,49,57,100,100,82,100,56,84,25,47,11,0,13,12,0,4,0,9,0,0,0,32,1,0,26,0,33,19,3,0,4,0,45
42,49,87,82,96,94,38,31,57,12,39,0,12,0,12,0,0,0,9,12,0,0,27,6,26,0,0,2,5,2,29,14,16,24,55,66,100,100,91,100,100,92,43,32,30,47,31,0,0,33,0,0,0,0,32,6,0,15,0,0,3,0,0,7,0,12,0
66,56,91,78,100,73,42,57,39,31,0,0,12,22,0,0,0,0,13,21,3,25,0,0,14,2,16,0,0,3,0,0,28,20,57,34,71,70,71,100,62,88,68,66,65,20,23,30,20,0,50,14,39,9,16,0,30,12,0,24,0,10,27,0,28,29
83,85,100,95,85,100,100,94,22,0,0,1,23,8,28,0,0,28,0,0,29,0,5,10,8,26,0,0,20,0,9,31,0,0,38,23,100,94,100,100,100,100,94,76,58,40,18,55,50,53,40,53,36,37,21,45,0,30,0,13,0,0,32,10,0
100,100,100,100,79,100,100,97,94,53,0,26,0,10,0,11,25,0,16,27,5,0,4,36,21,35,7,0,15,0,34,2,10,13,0,54,48,60,93,96,100,49,50,87,25,45,52,53,27,87,69,42,69,30,32,47,0,6,0,4,0,7,0,1
92,100,100,100,100,100,70,100,87,72,28,6,0,27,0,0,0,28,10,0,32,5,18,0,2,0,0,13,50,35,21,26,0,39,44,47,27,70,74,94,72,66,90,61,75,85,78,79,51,78,76,90,81,69,38,40,50,28,21,0,0,1,0
100,100,92,77,75,94,91,91,57,73,56,31,15,0,0,0,32,0,0,0,0,0,0,0,52,31,48,52,18,61,49,44,0,12,32,11,43,46,53,81,83,93,64,100,100,96,100,100,100,100,100,95,99,57,26,67,23,0,4,1,0,0
45,89,99,89,79,77,81,77,77,47,19,38,5,33,23,31,0,31,7,0,0,9,40,57,28,39,48,90,67,68,38,21,0,10,0,0,23,49,26,68,57,74,76,95,100,100,74,100,72,100,90,98,86,72,93,77,33,30,22,0,0
68,70,82,80,82,100,96,62,65,60,1,17,6,0,35,12,0,23,8,52,37,78,28,98,81,100,83,100,52,43,23,29,23,0,0,12,0,30,10,52,95,63,100,100,96,100,86,100,100,100,100,100,100,100,76,69,29,9,8,1
24,79,51,91,100,100,100,69,35,51,0,7,0,14,0,0,21,43,18,82,67,89,60,66,90,94,100,100,100,91,84,33,46,20,27,20,0,0,32,71,64,100,94,100,100,85,71,94,78,100,70,79,100,71,81,32,66,31,40
15,51,22,64,75,31,78,64,18,40,36,0,36,28,21,55,18,78,69,100,100,100,86,88,100,70,97,89,100,56,36,7,42,19,36,20,21,23,7,60,84,91,100,100,100,69,78,100,82,99,72,85,72,77,100,75,69,13
13,5,56,44,23,59,17,0,40,34,0,0,0,0,8,64,30,55,93,100,100,79,100,92,100,100,92,100,100,63,27,34,29,21,10,1,0,2,0,64,72,72,100,100,100,83,100,76,100,86,73,93,100,100,100,87,77
13,12,35,0,33,0,0,0,0,18,0,0,2,14,32,70,75,81,72,84,100,90,100,72,100,71,100,100,68,46,74,30,22,19,25,0,19,0,13,21,61,45,100,89,81,70,89,80,100,100,93,100,100,74,100,59
25,27,0,25,15,26,33,0,29,0,0,0,24,22,29,84,87,76,83,71,100,100,100,100,99,91,72,100,57,76,34,0,15,0,4,11,5,0,0,42,55,22,70,70,100,100,100,100,90,70,100,100,100,89,100
0,20,1,0,2,0,31,0,2,3,0,0,12,16,24,65,64,90,84,100,69,100,100,100,100,100,85,40,69,43,33,14,25,0,3,0,28,6,4,15,47,6,46,56,52,64,80,53,79,79,100,100,100,100
22,0,0,0,10,18,2,0,18,1,0,24,31,17,17,18,61,100,96,100,100,100,100,96,72,68,85,63,39,38,0,0,18,7,0,0,3,28,0,33,34,5,6,43,21,51,20,27,15,70,92,100,100
0,0,12,19,0,0,0,0,0,0,0,7,22,5,6,36,69,100,100,100,100,82,76,72,69,36,27,44,7,24,14,34,31,23,9,21,16,14,18,3,31,28,24,31,2,17,11,29,18,51,62,47
28,9,0,15,7,15,14,0,0,0,23,0,0,9,0,17,33,82,64,79,44,100,37,82,46,11,39,31,8,6,0,0,0,0,0,4,1,0,14,0,25,0,20,30,37,0,36,38,34,33,28
0,0,19,12,6,7,0,27,8,1,24,0,0,25,0,16,19,61,7,43,64,60,39,11,41,28,32,0,27,23,0,0,0,0,0,30,0,0,0,31,23,23,3,8,0,33,2,3,30,38
0,1,30,30,19,7,7,14,0,5,23,0,25,32,0,0,30,0,0,43,36,1,30,35,0,29,24,2,0,0,0,16,0,16,0,0,4,0,1,1,0,10,12,0,15,0,0,29,30
0,0,0,0,0,24,0,0,28,0,0,1,0,13,0,0,9,0,0,40,30,0,2,0,0,11,0,0,21,0,25,0,23,0,0,0,16,1,0,0,0,18,27,0,0,5,0,0
0,22,10,0,0,0,19,0,31,0,11,26,22,32,0,0,0,28,32,20,29,5,16,9,0,34,0,24,16,11,8,26,0,29,0,23,0,31,0,8,15,0,25,0,0,29,20
9,0,25,0,28,28,0,0,0,30,14,0,0,0,0,0,14,0,0,0,0,0,0,0,7,19,0,15,4,0,0,24,18,16,0,22,0,0,24,27,18,21,0,0,0,29
24,0,11,31,0,12,0,14,0,23,0,0,0,6,0,0,18,8,8,0,31,0,11,7,24,1,27,0,11,0,0,0,20,4,14,0,5,0,0,0,24,4,16,0,0
0,23,18,0,6,24,0,0,7,11,21,0,0,16,31,31,19,6,22,14,0,17,3,23,5,30,0,13,5,0,0,0,0,0,0,27,24,24,0,31,0,0,7,0
0,0,0,0,0,0,25,3,0,12,14,0,0,6,9,12,28,20,5,12,5,0,0,11,0,18,0,0,0,17,17,0,0,0,4,0,0,0,0,0,0,1,0
22,0,4,21,0,0,0,3,15,19,10,2,0,0,12,2,0,0,13,23,31,14,0,2,20,21,27,9,11,21,0,0,22,29,3,10,0,0,7,25,0,0
0,12,0,0,0,16,0,12,20,21,1,0,0,0,0,0,0,0,0,15,0,0,0,9,0,16,0,0,0,15,0,31,0,0,1,0,0,0,0,0,0
0,0,0,31,22,0,21,28,31,0,0,0,0,0,0,9,24,0,0,0,11,26,0,0,11,0,25,13,0,1,29,0,20,0,27,0,0,0,29,29
0,0,0,9,9,0,3,7,0,0,0,27,16,31,10,0,0,0,1,0,25,0,18,1,0,4,17,0,16,0,0,0,24,0,0,7,0,21,17
30,6,0,1,0,4,0,0,29,16,30,0,0,13,0,0,4,8,26,4,0,0,25,12,7,0,5,25,0,27,0,0,2,0,0,9,19,0
6,27,0,5,24,0,0,0,0,24,0,0,2,0,0,0,0,0,0,22,0,5,0,0,0,17,11,0,0,0,0,15,0,5,0,0,31
0,21,22,24,5,0,0,0,22,0,0,22,28,0,20,0,0,21,7,7,0,19,29,31,4,27,0,25,2,0,0,11,9,0,0,0
31,0,0,10,25,18,24,0,24,12,5,0,21,0,0,21,26,2,0,0,18,0,12,0,12,0,18,18,14,0,0,0,27,0,12
0,3,14,11,4,0,7,0,19,4,30,0,0,0,16,0,8,0,26,0,0,0,0,14,5,0,0,3,0,0,22,0,9,0
0,12,28,0,0,27,0,9,26,0,20,17,0,0,0,4,0,16,0,1,21,17,0,20,0,0,0,26,7,14,0,0,0
12,18,0,30,3,25,13,17,0,0,0,21,0,0,31,0,0,0,9,14,29,10,9,16,4,0,11,25,7,6,24,12
23,11,17,28,0,0,0,6,0,0,0,0,0,0,0,0,0,10,0,0,0,27,0,0,0,18,0,9,17,12,0
0,0,0,0,18,11,0,0,0,0,13,8,0,28,0,5,0,22,0,0,20,0,32,4,0,0,0,19,0,0
18,7,24,29,0,0,0,0,0,0,0,14,4,0,11,17,12,0,0,6,0,0,0,4,0,0,30,28,12
0,2,0,13,0,0,14,0,0,28,7,0,22,15,22,20,25,16,0,0,4,12,2,0,15,0,0,0
0,0,15,8,0,0,0,21,24,22,29,0,8,8,23,0,3,13,0,27,0,0,2,0,1,22,0
0,21,0,13,0,0,0,0,15,0,0,0,7,23,0,0,23,0,0,0,0,0,0,0,0,0
11,1,14,8,6,0,0,0,23,0,29,27,0,0,28,29,16,2,13,17,0,0,4,30,16
29,0,26,0,0,0,0,0,32,19,0,22,0,27,0,0,10,17,0,0,0,0,7,2
1,0,26,11,24,0,0,0,0,0,0,30,0,0,20,5,29,19,0,11,0,5,0
0,0,0,7,21,0,0,17,0,17,9,0,0,0,17,0,0,0,0,28,0,0
0,4,0,4,6,27,23,0,2,21,0,20,0,15,21,10,0,2,0,16,0
0,0,0,18,2,0,23,0,2,14,0,0,17,0,15,0,0,0,0,0
0,0,9,0,0,0,28,23,2,25,21,23,0,19,0,0,0,0,32
0,0,0,0,0,10,24,19,0,0,30,0,0,0,0,0,32,22
0,0,0,32,13,28,0,24,0,29,14,0,0,0,0,0,0
20,0,31,0,0,25,0,27,0,0,0,32,0,11,0,0
0,0,0,13,0,0,0,2,4,29,0,0,0,0,0
1,7,0,0,0,0,31,21,10,0,1,6,0,0
0,0,0,0,0,0,29,8,23,0,18,4,0
5,0,12,0,0,0,23,0,0,0,0,0
14,0,0,28,0,11,28,0,11,15,16
0,0,0,16,14,8,0,8,15,0
21,5,0,0,0,0,0,0,0
28,0,21,3,0,0,0,0
0,19,9,0,0,12,4
26,22,0,1,21,6
31,4,26,0,0
10,0,9,0
16,15,5
0,0
20
